Hashin Kodesh

Letters
	1) Meaning
	2) Shape
	3) Gematria
	4) 1st Occurrence


create/bara
word/debar

a'bara k'dabra
I create from Word


aleph - פלא
	1) empowering
		aloof = champion, general, wisdom (alphia)
		א God
		ל teaches
		פ mouth

		אלפ - pelah/incomprehensible
		ammona - trust/faith
		White, composed of 7 colors
		lav'n - white
			lav - heart
			n - depth
		kaochol - blue
			kao - power
			chol - study
	3) 1, 1000
		111 - פלא
		teba - nature - 86
			same gematria as elokhim
			or teva - drown (faith)
		bachar - choice
			chabar - join
			charab - sword
		aneg - pleasure
			nega - disease
		sh'pha - abundance
			p'sha - sin
		ash'r - wealth
			r'sha - evil
		sara - pain
			ratsa - will
		tsar - suffering
			ar - awaken
			ra - bitter
		an's - punishment
			a - eye
			n's - (n'sr eagle/shear feather falls/wool falls) - fall back
		azn - ear
			izn - balance
	4) elokhim - plural


pe
	mouth

gimel - female/camel/kindness (self-sufficiency)
	1) gi - give
		mel - cut-off
	4) gadol - big


vav - and
	1) hook, connector
		tzug - married couple - tsayin vav gimel (male hooked to female)
	4) vavay - hooks of the curtain


tsayin - male/protector/provider
	tsadik - righteous person

	4) zera - seed


adam - man - Al blood
	m't - death - 44
adamah - soil - 
	a demah - be dirt
	a domah - compared to God
a'm't - truth

ish - 
anosh - fell-away from Al
